A A . . . .
. . . B B B
. X X . . .
. . . . . .
C C C . D D
. . F F . . 