A . . . . .
A X X B B .
. . . . . .
. . . . C C
D D D . . .
. . F F F G 