A . . . . .
A X X B . .
. . . B . .
. . . . . .
C C . D D D
. . . . . . 