A A . . B B
. . . . . .
. X X . C .
. . . . C .
. . D D D .
E E F F G G 