A A . . . .
. . . B B .
. X X . . .
. . . . . .
C C . D D D
. . . . . . 